11111111111111
10000C00000001
1E0000000C0001
1000P000000001
1000000C000001
11111111111111
